Country,Year,Antibiotic_Group,S,I,R,TotalN,pS,pI,pR
Austria,2005,Carbapenems,80,0,0,80,100.0 %,0.0 %,0.0 %
Austria,2006,Carbapenems,269,0,0,269,100.0 %,0.0 %,0.0 %
Austria,2007,Carbapenems,305,1,0,306,99.7 %,0.3 %,0.0 %
Austria,2008,Carbapenems,397,0,0,397,100.0 %,0.0 %,0.0 %
Austria,2009,Carbapenems,463,0,0,463,100.0 %,0.0 %,0.0 %
Austria,2010,Carbapenems,506,0,3,509,99.4 %,0.0 %,0.6 %
Austria,2011,Carbapenems,608,1,1,610,99.7 %,0.2 %,0.2 %
Austria,2012,Carbapenems,727,5,6,738,98.5 %,0.7 %,0.8 %
Austria,2013,Carbapenems,897,2,11,910,98.6 %,0.2 %,1.2 %
Belgium,2009,Carbapenems,82,0,1,83,98.8 %,0.0 %,1.2 %
Belgium,2010,Carbapenems,116,0,0,116,100.0 %,0.0 %,0.0 %
Belgium,2011,Carbapenems,644,0,2,646,99.7 %,0.0 %,0.3 %
Belgium,2012,Carbapenems,540,1,4,545,99.1 %,0.2 %,0.7 %
Belgium,2013,Carbapenems,612,4,2,618,99.0 %,0.6 %,0.3 %
Bulgaria,2005,Carbapenems,30,0,0,30,100.0 %,0.0 %,0.0 %
Bulgaria,2006,Carbapenems,47,0,0,47,100.0 %,0.0 %,0.0 %
Bulgaria,2007,Carbapenems,27,0,0,27,100.0 %,0.0 %,0.0 %
Bulgaria,2008,Carbapenems,45,0,0,45,100.0 %,0.0 %,0.0 %
Bulgaria,2009,Carbapenems,87,1,0,88,98.9 %,1.1 %,0.0 %
Bulgaria,2010,Carbapenems,126,0,0,126,100.0 %,0.0 %,0.0 %
Bulgaria,2011,Carbapenems,116,0,0,116,100.0 %,0.0 %,0.0 %
Bulgaria,2012,Carbapenems,106,0,2,108,98.1 %,0.0 %,1.9 %
Bulgaria,2013,Carbapenems,129,0,0,129,100.0 %,0.0 %,0.0 %
Croatia,2010,Carbapenems,260,13,6,279,93.2 %,4.7 %,2.2 %
Croatia,2011,Carbapenems,298,1,0,299,99.7 %,0.3 %,0.0 %
Croatia,2012,Carbapenems,329,2,0,331,99.4 %,0.6 %,0.0 %
Croatia,2013,Carbapenems,371,3,2,376,98.7 %,0.8 %,0.5 %
Cyprus,2005,Carbapenems,9,0,0,9,100.0 %,0.0 %,0.0 %
Cyprus,2006,Carbapenems,26,0,0,26,100.0 %,0.0 %,0.0 %
Cyprus,2007,Carbapenems,38,0,1,39,97.4 %,0.0 %,2.6 %
Cyprus,2008,Carbapenems,56,0,6,62,90.3 %,0.0 %,9.7 %
Cyprus,2009,Carbapenems,43,1,9,53,81.1 %,1.9 %,17.0 %
Cyprus,2010,Carbapenems,55,1,11,67,82.1 %,1.5 %,16.4 %
Cyprus,2011,Carbapenems,69,1,13,83,83.1 %,1.2 %,15.7 %
Cyprus,2012,Carbapenems,59,0,6,65,90.8 %,0.0 %,9.2 %
Cyprus,2013,Carbapenems,63,1,4,68,92.6 %,1.5 %,5.9 %
Czech Republic,2005,Carbapenems,44,0,0,44,100.0 %,0.0 %,0.0 %
Czech Republic,2006,Carbapenems,15,0,0,15,100.0 %,0.0 %,0.0 %
Czech Republic,2007,Carbapenems,287,0,0,287,100.0 %,0.0 %,0.0 %
Czech Republic,2008,Carbapenems,1257,0,3,1260,99.8 %,0.0 %,0.2 %
Czech Republic,2009,Carbapenems,1211,0,3,1214,99.8 %,0.0 %,0.2 %
Czech Republic,2010,Carbapenems,1100,2,1,1103,99.7 %,0.2 %,0.1 %
Czech Republic,2011,Carbapenems,1187,5,1,1193,99.5 %,0.4 %,0.1 %
Czech Republic,2012,Carbapenems,1298,5,4,1307,99.3 %,0.4 %,0.3 %
Czech Republic,2013,Carbapenems,1121,6,6,1133,98.9 %,0.5 %,0.5 %
Denmark,2006,Carbapenems,44,0,0,44,100.0 %,0.0 %,0.0 %
Denmark,2007,Carbapenems,93,0,0,93,100.0 %,0.0 %,0.0 %
Denmark,2008,Carbapenems,522,0,1,523,99.8 %,0.0 %,0.2 %
Denmark,2009,Carbapenems,504,0,0,504,100.0 %,0.0 %,0.0 %
Denmark,2010,Carbapenems,491,0,0,491,100.0 %,0.0 %,0.0 %
Denmark,2011,Carbapenems,589,0,0,589,100.0 %,0.0 %,0.0 %
Denmark,2012,Carbapenems,678,0,2,680,99.7 %,0.0 %,0.3 %
Denmark,2013,Carbapenems,643,1,1,645,99.7 %,0.2 %,0.2 %
Estonia,2005,Carbapenems,26,0,0,26,100.0 %,0.0 %,0.0 %
Estonia,2006,Carbapenems,26,0,0,26,100.0 %,0.0 %,0.0 %
Estonia,2007,Carbapenems,48,0,0,48,100.0 %,0.0 %,0.0 %
Estonia,2008,Carbapenems,62,0,0,62,100.0 %,0.0 %,0.0 %
Estonia,2009,Carbapenems,50,0,0,50,100.0 %,0.0 %,0.0 %
Estonia,2010,Carbapenems,66,0,0,66,100.0 %,0.0 %,0.0 %
Estonia,2011,Carbapenems,73,0,0,73,100.0 %,0.0 %,0.0 %
Estonia,2012,Carbapenems,78,0,1,79,98.7 %,0.0 %,1.3 %
Estonia,2013,Carbapenems,72,0,2,74,97.3 %,0.0 %,2.7 %
Finland,2005,Carbapenems,131,0,0,131,100.0 %,0.0 %,0.0 %
Finland,2006,Carbapenems,214,0,0,214,100.0 %,0.0 %,0.0 %
Finland,2007,Carbapenems,251,0,0,251,100.0 %,0.0 %,0.0 %
Finland,2008,Carbapenems,280,0,0,280,100.0 %,0.0 %,0.0 %
Finland,2009,Carbapenems,349,1,1,351,99.4 %,0.3 %,0.3 %
Finland,2010,Carbapenems,390,1,0,391,99.7 %,0.3 %,0.0 %
Finland,2011,Carbapenems,403,1,0,404,99.8 %,0.2 %,0.0 %
Finland,2012,Carbapenems,536,0,0,536,100.0 %,0.0 %,0.0 %
Finland,2013,Carbapenems,550,0,0,550,100.0 %,0.0 %,0.0 %
France,2005,Carbapenems,752,0,1,753,99.9 %,0.0 %,0.1 %
France,2006,Carbapenems,831,0,0,831,100.0 %,0.0 %,0.0 %
France,2007,Carbapenems,1056,0,1,1057,99.9 %,0.0 %,0.1 %
France,2008,Carbapenems,1020,1,0,1021,99.9 %,0.1 %,0.0 %
France,2009,Carbapenems,1262,4,2,1268,99.5 %,0.3 %,0.2 %
France,2010,Carbapenems,1428,3,1,1432,99.7 %,0.2 %,0.1 %
France,2011,Carbapenems,1638,2,0,1640,99.9 %,0.1 %,0.0 %
France,2012,Carbapenems,1610,9,8,1627,99.0 %,0.6 %,0.5 %
France,2013,Carbapenems,1821,9,12,1842,98.9 %,0.5 %,0.7 %
Germany,2005,Carbapenems,100,0,2,102,98.0 %,0.0 %,2.0 %
Germany,2006,Carbapenems,146,1,0,147,99.3 %,0.7 %,0.0 %
Germany,2007,Carbapenems,170,0,3,173,98.3 %,0.0 %,1.7 %
Germany,2008,Carbapenems,231,0,0,231,100.0 %,0.0 %,0.0 %
Germany,2009,Carbapenems,467,0,0,467,100.0 %,0.0 %,0.0 %
Germany,2010,Carbapenems,463,1,0,464,99.8 %,0.2 %,0.0 %
Germany,2011,Carbapenems,511,1,0,512,99.8 %,0.2 %,0.0 %
Germany,2012,Carbapenems,660,1,0,661,99.8 %,0.2 %,0.0 %
Germany,2013,Carbapenems,737,1,5,743,99.2 %,0.1 %,0.7 %
Greece,2005,Carbapenems,532,26,215,773,68.8 %,3.4 %,27.8 %
Greece,2006,Carbapenems,525,37,275,837,62.7 %,4.4 %,32.9 %
Greece,2007,Carbapenems,522,34,410,966,54.0 %,3.5 %,42.4 %
Greece,2008,Carbapenems,592,90,392,1074,55.1 %,8.4 %,36.5 %
Greece,2009,Carbapenems,788,131,708,1627,48.4 %,8.1 %,43.5 %
Greece,2010,Carbapenems,683,176,828,1687,40.5 %,10.4 %,49.1 %
Greece,2011,Carbapenems,478,43,1115,1636,29.2 %,2.6 %,68.2 %
Greece,2012,Carbapenems,549,28,883,1460,37.6 %,1.9 %,60.5 %
Greece,2013,Carbapenems,479,12,718,1209,39.6 %,1.0 %,59.4 %
Hungary,2005,Carbapenems,299,0,1,300,99.7 %,0.0 %,0.3 %
Hungary,2006,Carbapenems,283,2,0,285,99.3 %,0.7 %,0.0 %
Hungary,2007,Carbapenems,309,0,0,309,100.0 %,0.0 %,0.0 %
Hungary,2008,Carbapenems,360,0,0,360,100.0 %,0.0 %,0.0 %
Hungary,2009,Carbapenems,358,0,2,360,99.4 %,0.0 %,0.6 %
Hungary,2010,Carbapenems,462,2,27,491,94.1 %,0.4 %,5.5 %
Hungary,2011,Carbapenems,403,2,8,413,97.6 %,0.5 %,1.9 %
Hungary,2012,Carbapenems,463,4,14,481,96.3 %,0.8 %,2.9 %
Hungary,2013,Carbapenems,520,1,9,530,98.1 %,0.2 %,1.7 %
Iceland,2005,Carbapenems,21,0,0,21,100.0 %,0.0 %,0.0 %
Iceland,2006,Carbapenems,12,0,0,12,100.0 %,0.0 %,0.0 %
Iceland,2007,Carbapenems,26,0,0,26,100.0 %,0.0 %,0.0 %
Iceland,2008,Carbapenems,24,0,0,24,100.0 %,0.0 %,0.0 %
Iceland,2009,Carbapenems,26,0,0,26,100.0 %,0.0 %,0.0 %
Iceland,2010,Carbapenems,13,0,0,13,100.0 %,0.0 %,0.0 %
Ireland,2005,Carbapenems,26,0,0,26,100.0 %,0.0 %,0.0 %
Ireland,2006,Carbapenems,147,0,0,147,100.0 %,0.0 %,0.0 %
Ireland,2007,Carbapenems,173,1,0,174,99.4 %,0.6 %,0.0 %
Ireland,2008,Carbapenems,230,0,0,230,100.0 %,0.0 %,0.0 %
Ireland,2009,Carbapenems,253,0,0,253,100.0 %,0.0 %,0.0 %
Ireland,2010,Carbapenems,301,0,0,301,100.0 %,0.0 %,0.0 %
Ireland,2011,Carbapenems,299,2,1,302,99.0 %,0.7 %,0.3 %
Ireland,2012,Carbapenems,338,0,0,338,100.0 %,0.0 %,0.0 %
Ireland,2013,Carbapenems,315,1,1,317,99.4 %,0.3 %,0.3 %
Italy,2006,Carbapenems,299,2,4,305,98.0 %,0.7 %,1.3 %
Italy,2007,Carbapenems,354,2,4,360,98.3 %,0.6 %,1.1 %
Italy,2008,Carbapenems,300,3,6,309,97.1 %,1.0 %,1.9 %
Italy,2009,Carbapenems,300,0,4,304,98.7 %,0.0 %,1.3 %
Italy,2010,Carbapenems,615,5,111,731,84.1 %,0.7 %,15.2 %
Italy,2011,Carbapenems,433,18,164,615,70.4 %,2.9 %,26.7 %
Italy,2012,Carbapenems,580,19,246,845,68.6 %,2.2 %,29.1 %
Italy,2013,Carbapenems,930,24,499,1453,64.0 %,1.7 %,34.3 %
Latvia,2006,Carbapenems,26,0,0,26,100.0 %,0.0 %,0.0 %
Latvia,2007,Carbapenems,27,0,0,27,100.0 %,0.0 %,0.0 %
Latvia,2008,Carbapenems,39,0,1,40,97.5 %,0.0 %,2.5 %
Latvia,2009,Carbapenems,44,0,0,44,100.0 %,0.0 %,0.0 %
Latvia,2010,Carbapenems,62,1,0,63,98.4 %,1.6 %,0.0 %
Latvia,2011,Carbapenems,65,0,0,65,100.0 %,0.0 %,0.0 %
Latvia,2012,Carbapenems,77,0,0,77,100.0 %,0.0 %,0.0 %
Latvia,2013,Carbapenems,92,0,0,92,100.0 %,0.0 %,0.0 %
Lithuania,2006,Carbapenems,32,0,0,32,100.0 %,0.0 %,0.0 %
Lithuania,2007,Carbapenems,41,0,0,41,100.0 %,0.0 %,0.0 %
Lithuania,2008,Carbapenems,53,0,0,53,100.0 %,0.0 %,0.0 %
Lithuania,2009,Carbapenems,64,0,0,64,100.0 %,0.0 %,0.0 %
Lithuania,2010,Carbapenems,43,0,0,43,100.0 %,0.0 %,0.0 %
Lithuania,2011,Carbapenems,19,0,0,19,100.0 %,0.0 %,0.0 %
Lithuania,2012,Carbapenems,185,0,0,185,100.0 %,0.0 %,0.0 %
Lithuania,2013,Carbapenems,144,0,0,144,100.0 %,0.0 %,0.0 %
Luxembourg,2006,Carbapenems,2,0,0,2,100.0 %,0.0 %,0.0 %
Luxembourg,2007,Carbapenems,19,0,0,19,100.0 %,0.0 %,0.0 %
Luxembourg,2008,Carbapenems,2,0,0,2,100.0 %,0.0 %,0.0 %
Luxembourg,2009,Carbapenems,27,0,0,27,100.0 %,0.0 %,0.0 %
Luxembourg,2010,Carbapenems,57,0,0,57,100.0 %,0.0 %,0.0 %
Luxembourg,2011,Carbapenems,48,0,0,48,100.0 %,0.0 %,0.0 %
Luxembourg,2012,Carbapenems,47,1,0,48,97.9 %,2.1 %,0.0 %
Luxembourg,2013,Carbapenems,52,0,1,53,98.1 %,0.0 %,1.9 %
Malta,2005,Carbapenems,18,0,0,18,100.0 %,0.0 %,0.0 %
Malta,2006,Carbapenems,32,0,0,32,100.0 %,0.0 %,0.0 %
Malta,2007,Carbapenems,28,0,0,28,100.0 %,0.0 %,0.0 %
Malta,2008,Carbapenems,36,0,0,36,100.0 %,0.0 %,0.0 %
Malta,2009,Carbapenems,38,0,0,38,100.0 %,0.0 %,0.0 %
Malta,2010,Carbapenems,57,0,0,57,100.0 %,0.0 %,0.0 %
Malta,2011,Carbapenems,49,1,2,52,94.2 %,1.9 %,3.8 %
Malta,2012,Carbapenems,53,2,2,57,93.0 %,3.5 %,3.5 %
Malta,2013,Carbapenems,59,6,4,69,85.5 %,8.7 %,5.8 %
Netherlands,2005,Carbapenems,230,0,0,230,100.0 %,0.0 %,0.0 %
Netherlands,2006,Carbapenems,328,0,1,329,99.7 %,0.0 %,0.3 %
Netherlands,2007,Carbapenems,336,0,0,336,100.0 %,0.0 %,0.0 %
Netherlands,2008,Carbapenems,419,1,0,420,99.8 %,0.2 %,0.0 %
Netherlands,2009,Carbapenems,398,0,0,398,100.0 %,0.0 %,0.0 %
Netherlands,2010,Carbapenems,638,0,2,640,99.7 %,0.0 %,0.3 %
Netherlands,2011,Carbapenems,720,0,2,722,99.7 %,0.0 %,0.3 %
Netherlands,2012,Carbapenems,683,0,1,684,99.9 %,0.0 %,0.1 %
Netherlands,2013,Carbapenems,644,1,1,646,99.7 %,0.2 %,0.2 %
Norway,1999,Carbapenems,5,0,0,5,100.0 %,0.0 %,0.0 %
Norway,2000,Carbapenems,11,0,0,11,100.0 %,0.0 %,0.0 %
Norway,2001,Carbapenems,9,0,0,9,100.0 %,0.0 %,0.0 %
Norway,2002,Carbapenems,15,0,0,15,100.0 %,0.0 %,0.0 %
Norway,2003,Carbapenems,21,0,0,21,100.0 %,0.0 %,0.0 %
Norway,2004,Carbapenems,29,1,0,30,96.7 %,3.3 %,0.0 %
Norway,2005,Carbapenems,160,0,1,161,99.4 %,0.0 %,0.6 %
Norway,2006,Carbapenems,219,1,1,221,99.1 %,0.5 %,0.5 %
Norway,2007,Carbapenems,274,0,0,274,100.0 %,0.0 %,0.0 %
Norway,2008,Carbapenems,295,0,2,297,99.3 %,0.0 %,0.7 %
Norway,2009,Carbapenems,350,2,0,352,99.4 %,0.6 %,0.0 %
Norway,2010,Carbapenems,448,0,0,448,100.0 %,0.0 %,0.0 %
Norway,2011,Carbapenems,442,1,0,443,99.8 %,0.2 %,0.0 %
Norway,2012,Carbapenems,620,0,3,623,99.5 %,0.0 %,0.5 %
Norway,2013,Carbapenems,644,0,1,645,99.8 %,0.0 %,0.2 %
Poland,2005,Carbapenems,33,0,0,33,100.0 %,0.0 %,0.0 %
Poland,2006,Carbapenems,17,0,0,17,100.0 %,0.0 %,0.0 %
Poland,2007,Carbapenems,12,1,0,13,92.3 %,7.7 %,0.0 %
Poland,2008,Carbapenems,8,0,0,8,100.0 %,0.0 %,0.0 %
Poland,2009,Carbapenems,138,0,1,139,99.3 %,0.0 %,0.7 %
Poland,2010,Carbapenems,238,0,0,238,100.0 %,0.0 %,0.0 %
Poland,2011,Carbapenems,369,5,2,376,98.1 %,1.3 %,0.5 %
Poland,2012,Carbapenems,352,4,3,359,98.1 %,1.1 %,0.8 %
Poland,2013,Carbapenems,366,1,3,370,98.9 %,0.3 %,0.8 %
Portugal,2007,Carbapenems,57,0,0,57,100.0 %,0.0 %,0.0 %
Portugal,2008,Carbapenems,137,0,1,138,99.3 %,0.0 %,0.7 %
Portugal,2009,Carbapenems,481,0,4,485,99.2 %,0.0 %,0.8 %
Portugal,2010,Carbapenems,436,1,6,443,98.4 %,0.2 %,1.4 %
Portugal,2011,Carbapenems,577,1,2,580,99.5 %,0.2 %,0.3 %
Portugal,2012,Carbapenems,743,1,5,749,99.2 %,0.1 %,0.7 %
Portugal,2013,Carbapenems,882,6,16,904,97.6 %,0.7 %,1.8 %
Romania,2005,Carbapenems,1,0,0,1,100.0 %,0.0 %,0.0 %
Romania,2006,Carbapenems,32,0,0,32,100.0 %,0.0 %,0.0 %
Romania,2007,Carbapenems,23,0,0,23,100.0 %,0.0 %,0.0 %
Romania,2008,Carbapenems,5,0,0,5,100.0 %,0.0 %,0.0 %
Romania,2009,Carbapenems,1,0,0,1,100.0 %,0.0 %,0.0 %
Romania,2010,Carbapenems,14,0,0,14,100.0 %,0.0 %,0.0 %
Romania,2011,Carbapenems,10,0,0,10,100.0 %,0.0 %,0.0 %
Romania,2012,Carbapenems,87,1,14,102,85.3 %,1.0 %,13.7 %
Romania,2013,Carbapenems,167,4,44,215,77.7 %,1.9 %,20.5 %
Slovakia,2011,Carbapenems,431,0,3,434,99.3 %,0.0 %,0.7 %
Slovakia,2012,Carbapenems,308,2,21,331,93.1 %,0.6 %,6.3 %
Slovakia,2013,Carbapenems,340,0,2,342,99.4 %,0.0 %,0.6 %
Slovenia,2005,Carbapenems,44,0,0,44,100.0 %,0.0 %,0.0 %
Slovenia,2006,Carbapenems,117,0,0,117,100.0 %,0.0 %,0.0 %
Slovenia,2007,Carbapenems,144,1,0,145,99.3 %,0.7 %,0.0 %
Slovenia,2008,Carbapenems,157,0,0,157,100.0 %,0.0 %,0.0 %
Slovenia,2009,Carbapenems,188,0,1,189,99.5 %,0.0 %,0.5 %
Slovenia,2010,Carbapenems,194,0,1,195,99.5 %,0.0 %,0.5 %
Slovenia,2011,Carbapenems,231,1,0,232,99.6 %,0.4 %,0.0 %
Slovenia,2012,Carbapenems,252,1,1,254,99.2 %,0.4 %,0.4 %
Slovenia,2013,Carbapenems,244,0,1,245,99.6 %,0.0 %,0.4 %
Spain,2005,Carbapenems,54,0,0,54,100.0 %,0.0 %,0.0 %
Spain,2006,Carbapenems,468,0,0,468,100.0 %,0.0 %,0.0 %
Spain,2007,Carbapenems,570,0,0,570,100.0 %,0.0 %,0.0 %
Spain,2008,Carbapenems,586,0,0,586,100.0 %,0.0 %,0.0 %
Spain,2009,Carbapenems,574,0,1,575,99.8 %,0.0 %,0.2 %
Spain,2010,Carbapenems,1161,0,0,1161,100.0 %,0.0 %,0.0 %
Spain,2011,Carbapenems,1138,2,4,1144,99.5 %,0.2 %,0.3 %
Spain,2012,Carbapenems,1136,7,9,1152,98.6 %,0.6 %,0.8 %
Spain,2013,Carbapenems,1212,9,20,1241,97.7 %,0.7 %,1.6 %
Sweden,2005,Carbapenems,16,0,0,16,100.0 %,0.0 %,0.0 %
Sweden,2006,Carbapenems,3,0,0,3,100.0 %,0.0 %,0.0 %
Sweden,2007,Carbapenems,525,0,0,525,100.0 %,0.0 %,0.0 %
Sweden,2008,Carbapenems,638,1,0,639,99.8 %,0.2 %,0.0 %
Sweden,2009,Carbapenems,1,0,0,1,100.0 %,0.0 %,0.0 %
Sweden,2012,Carbapenems,45,0,0,45,100.0 %,0.0 %,0.0 %
Sweden,2013,Carbapenems,1269,0,0,1269,100.0 %,0.0 %,0.0 %
United Kingdom,2005,Carbapenems,275,0,0,275,100.0 %,0.0 %,0.0 %
United Kingdom,2006,Carbapenems,285,0,1,286,99.7 %,0.0 %,0.3 %
United Kingdom,2007,Carbapenems,301,0,1,302,99.7 %,0.0 %,0.3 %
United Kingdom,2008,Carbapenems,239,0,3,242,98.8 %,0.0 %,1.2 %
United Kingdom,2009,Carbapenems,588,2,1,591,99.5 %,0.3 %,0.2 %
United Kingdom,2010,Carbapenems,674,2,1,677,99.6 %,0.3 %,0.1 %
United Kingdom,2011,Carbapenems,821,1,3,825,99.5 %,0.1 %,0.4 %
United Kingdom,2012,Carbapenems,880,4,4,888,99.1 %,0.5 %,0.5 %
United Kingdom,2013,Carbapenems,1044,2,5,1051,99.3 %,0.2 %,0.5 %
